        ####
        #  ##############
        #               #
        # ## ####       #
 ####   #    #  ######  #
 #  ##### ####       # ##
 #               ##  # #
 #   # ### # #  ##  ## #
## ### # # # #  #   #  #
#            ##$+** #  #
#   #######     $*.    #
#####     ###### ## #  #
               # #  ####
               #   ##
               #####