 #########
 #   .*  ####
 #   # # #  #
#### #   #  #
#    # #    #
# # # $ ###.#
#*   $@$   *#
#.### $ # # #
#    # #    #
#  #   # ####
#  # # #   #
####  *.   #
   #########