          ####
   ########  ###
   #           ####
   #              #
  ### ######      #
 ## .*     ####   #
 #  *$   ###  ### #
 #   #   #      # #
##  ########    # #
#          ###### ##
#   #####   #  #   #
#####   # ###  $*  #
        #      *+###
        #   ######
        #####