    #####
    #   # #####
    # # ###   #
    #         #
  ####  ### ###
 ##   .## # #
 #   **   # #
### **    # #
#  ** ##  # ##
#  $@  ####  #
####         #
   #  ########
   ####