       ####
#########
#       #
#       #
#       #
#      .#
#@  ######     
##       #
 #       #
 #       #
 #     $ #
 #   #####
 #####