#####         #####
#    #########    #
#                 #
##                #
 #         ###   ##
 ## $  # ..  $ @##
 #  ##    ####   ##
#                 #
#  ############   #
####          #####