###########
#         ##
#    $    ##
#    $    ##
# @   ..   #
#          #
############